E ######## #####################
#    ##### ############## ######
## # ##### ### ####       ######
## # ##### ### #### ##### ######
#  #                           #
# ## ############# ## ### #### #
# ##      ######## ## ### #### #
# ## ####       ##     ## #### #
# ## #### ##### ## ### ## #### #
#                          ### #
##########################     S