E  ############################
   #           #     #        #
#  #  #############  #  #######
#  #  #  #        #  #  #  #  #
#  #  #  #  #  #  #  #  #  #  #
#           #  #  #        #  #
#  ####  #  ####  #######  #  #
#  #     #  #     #     #     #
#  ####  #############  #  #  #
#     #     #     #        #  #
#  #  ####  ####  #  #  #  #  #
#  #     #  #        #  #  #  #
#  ##########  ####  #  ####  #
#              #  #  #  #  #  #
#  #  ##########  #  #  #  ####
#  #        #     #  #     #  #
#  ####  ####  ##########  #  #
#  #  #     #                 #
####  #  #######  #  #  ####  #
#              #  #  #  #      
############################  S 